7
####
# .#
#  ###
#*@  #
#    # 
#    #
######